                                        
 ############################# ########                      
 #   #        #  #                    #  
 #   #        #  ##################   #  
 #   #        #            #      #   #  
 #   #        #            #      #   #  
 #   #######  #   ##########      #   #  
 ###       #  #            #      #   #  
 ####################      #      #####  
 #####       #                    #   #  
 #           #                    #     
 #           #       #            #   $ 
 #           #       #            #   # 
 #           #       #            #   # 
             #       #            #   # 
  ################   ###############  # 
                #            #        # 
                #            ########## 
                          
                                        
